11111111111111111
1P0000000C0100001
10C00001110000001
10010000C00000001
10010000100000001
10001001000000111
1C011000000C00CE1
11111111111111111